ЁЯУД ржбржХрзБржорзЗржирзНржЯ рж╕рзНржЯрзНрж░рж╛ржХржЪрж╛рж░ HTML ржЯрзНржпрж╛ржЧ	ржХрж╛ржЬ

<html>	ржкрзБрж░рзЛ HTML ржбржХрзБржорзЗржирзНржЯрзЗрж░ рж░рзБржЯ ржПрж▓рж┐ржорзЗржирзНржЯ
<head>	ржорзЗржЯрж╛ рждржерзНржп, рж╢рж┐рж░рзЛржирж╛ржо, рж╕рзНржЯрж╛ржЗрж▓ рж╢рзАржЯ ржЗрждрзНржпрж╛ржжрж┐ ржерж╛ржХрзЗ
<title>	ржкрзЗржЬрзЗрж░ рж╢рж┐рж░рзЛржирж╛ржо (ржмрзНрж░рж╛ржЙржЬрж╛рж░рзЗрж░ ржЯрзНржпрж╛ржмрзЗ ржжрзЗржЦрж╛рзЯ)
<body>	ржжрзГрж╢рзНржпржорж╛ржи ржХржиржЯрзЗржирзНржЯ

ЁЯза ржорзЗржЯрж╛ржбрзЗржЯрж╛ HTML ржЯрзНржпрж╛ржЧ	ржХрж╛ржЬ

<meta>	ржорзЗржЯрж╛ рждржерзНржп ржпрзЗржоржи ржХрзНржпрж╛рж░рзЗржХржЯрж╛рж░ рж╕рзЗржЯ, ржмрж░рзНржгржирж╛ ржЗрждрзНржпрж╛ржжрж┐
<link>	ржПржХрзНрж╕ржЯрж╛рж░рзНржирж╛рж▓ CSS ржмрж╛ ржлрзЗржнрж┐ржХржи ржпрзБржХрзНржд ржХрж░рждрзЗ
<style>	ржкрзЗржЬрзЗрж░ ржнрж┐рждрж░рзЗ CSS рж▓рзЗржЦрж╛рж░ ржЬржирзНржп
<base>	рж▓рж┐ржЩрзНржХрзЗрж░ ржнрж┐рждрзНрждрж┐ URL ржирж┐рж░рзНржзрж╛рж░ржг

ЁЯзй ржХржирзНржЯрзЗржирзНржЯ ржнрж╛ржЧ ржХрж░рж╛/ржмрж┐ржнрж╛ржЧ ржнрж┐рждрзНрждрж┐ржХ ржПрж▓рж┐ржорзЗржирзНржЯ HTML ржЯрзНржпрж╛ржЧ	ржХрж╛ржЬ

<header>	рж╢рж┐рж░рзЛржирж╛ржо ржЕржВрж╢
<footer>	ржирж┐ржЪрзЗрж░ ржЕржВрж╢ ржмрж╛ ржкрж╛ржжржЯрзАржХрж╛
<main>  	ржкрзНрж░ржзрж╛ржи ржХржиржЯрзЗржирзНржЯ
<section>	ржПржХржЯрж┐ ржирж┐рж░рзНржжрж┐рж╖рзНржЯ ржмрж┐ржнрж╛ржЧ
<article>	ржЖрж▓рж╛ржжрж╛ рж▓рзЗржЦрж╛ ржмрж╛ ржкрзЛрж╕рзНржЯ
<nav>   	ржирзЗржнрж┐ржЧрзЗрж╢ржи рж▓рж┐ржЩрзНржХ
<aside> 	ржкрж╛рж╢рзЗрж░ ржХржиржЯрзЗржирзНржЯ (рж╕рж╛ржЗржбржмрж╛рж░ ржЗрждрзНржпрж╛ржжрж┐)
<address>	ржарж┐ржХрж╛ржирж╛ ржмрж╛ ржпрзЛржЧрж╛ржпрзЛржЧ рждржерзНржп

тЬНя╕П ржЯрзЗржХрзНрж╕ржЯ ржХржиржЯрзЗржирзНржЯ HTML ржЯрзНржпрж╛ржЧ ржХрж╛ржЬ

<h1> ржерзЗржХрзЗ <h6>	рж╢рж┐рж░рзЛржирж╛ржо (ржмрзЬ ржерзЗржХрзЗ ржЫрзЛржЯ)
<p>             ржЕржирзБржЪрзНржЫрзЗржж
<div>   	рж╕рж╛ржзрж╛рж░ржг ржХржиржЯрзЗржЗржирж╛рж░
<span>  	ржЗржирж▓рж╛ржЗржи ржХржиржЯрзЗржЗржирж╛рж░
<pre>	        ржкрзВрж░рзНржм-ржлрж░ржорзНржпрж╛ржЯрзЗржб ржЯрзЗржХрзНрж╕ржЯ
<blockquote>	ржЙржжрзНржзрзГрждрж┐
<hr>    	ржжрж╛ржЧ ржмрж╛ ржмрж┐ржнрж╛ржЬржХ рж░рзЗржЦрж╛
<br>    	рж▓рж╛ржЗржирзЗрж░ ржмрзНрж░рзЗржХ

тЬи ржЗржирж▓рж╛ржЗржи ржЯрзЗржХрзНрж╕ржЯ ржПрж▓рж┐ржорзЗржирзНржЯ HTML ржЯрзНржпрж╛ржЧ ржХрж╛ржЬ

<strong>	ржЧрзБрж░рзБрждрзНржмржкрзВрж░рзНржг ржЯрзЗржХрзНрж╕ржЯ (ржЧрж╛рзЭ)
<em>    	ржЧрзБрж░рзБрждрзНржм ржжрзЗржУрзЯрж╛ ржЯрзЗржХрзНрж╕ржЯ (italic)
<mark>  	рж╣рж╛ржЗрж▓рж╛ржЗржЯ ржХрж░рж╛ рж▓рзЗржЦрж╛
<abbr>  	рж╕ржВржХрзНрж╖рж┐ржкрзНржд рж░рзВржк
<cite>  	ржХрзЛржирзЛ рж░ржЪржирж╛/ржирж╛ржо ржЙрж▓рзНрж▓рзЗржЦ
<code>  	ржХрзЛржб ржмрзНрж▓ржХ
<sup>   	ржУржкрж░рзЗрж░ рж▓рзЗржЦрж╛рж░ ржЬржирзНржп
<sub>   	ржирж┐ржЪрзЗрж░ рж▓рзЗржЦрж╛рж░ ржЬржирзНржп
<small>  	ржЫрзЛржЯ рж▓рзЗржЦрж╛
<u>     	ржЖржирзНржбрж╛рж░рж▓рж╛ржЗржи
<b>     	ржЧрж╛рзЭ рж▓рзЗржЦрж╛
<i>     	italic рж▓рзЗржЦрж╛

ЁЯЦ╝я╕П ржорж┐ржбрж┐рзЯрж╛ ржУ ржЫржмрж┐ HTML ржЯрзНржпрж╛ржЧ ржХрж╛ржЬ

<img>   	ржЫржмрж┐ ржжрзЗржЦрж╛ржирзЛрж░ ржЬржирзНржп
<audio>	        ржЕржбрж┐ржУ ржЪрж╛рж▓рж╛ржирзЛрж░ ржЬржирзНржп
<video> 	ржнрж┐ржбрж┐ржУ ржЪрж╛рж▓рж╛ржирзЛрж░ ржЬржирзНржп
<source>	ржЕржбрж┐ржУ/ржнрж┐ржбрж┐ржУ рж╕рзЛрж░рзНрж╕
<track> 	рж╕рж╛ржмржЯрж╛ржЗржЯрзЗрж▓
<figure>	ржЫржмрж┐ ржмрж╛ ржЪрж╛рж░рзНржЯрзЗрж░ ржЬржирзНржп ржЧрзНрж░рзБржк
<figcaption>	ржЫржмрж┐ ржмрж╛ ржЪрж╛рж░рзНржЯрзЗрж░ ржХрзНржпрж╛ржкрж╢ржи

ЁЯФа ржлрж░рзНржо ржУ ржЗржиржкрзБржЯ HTML ржЯрзНржпрж╛ржЧ ржХрж╛ржЬ

<form>  	ржлрж░рзНржо рждрзИрж░рж┐ ржХрж░рждрзЗ
<input> 	ржЗржиржкрзБржЯ ржлрж┐рж▓рзНржб
<textarea>	ржмрзЬ рж▓рзЗржЦрж╛рж░ ржЗржиржкрзБржЯ
<button>	ржмрзЛрждрж╛ржо
<select>	ржбрзНрж░ржкржбрж╛ржЙржи
<option>	ржЕржкрж╢ржи ржЖржЗржЯрзЗржо
<label> 	ржЗржиржкрзБржЯ рж▓рзЗржмрзЗрж▓
<fieldset>	ржлрж░рзНржо ржПрж▓рж┐ржорзЗржирзНржЯ ржЧрзНрж░рзБржк
<legend>	ржлрж┐рж▓рзНржбрж╕рзЗржЯрзЗрж░ рж╢рж┐рж░рзЛржирж╛ржо
<datalist>	ржЗржиржкрзБржЯрзЗрж░ рж╕рж╛ржЬрзЗрж╢ржи
<output>	ржлрж░рзНржорзЗрж░ ржЖржЙржЯржкрзБржЯ

ЁЯзо ржЯрзЗржмрж┐рж▓ ржПрж▓рж┐ржорзЗржирзНржЯ HTML ржЯрзНржпрж╛ржЧ ржХрж╛ржЬ

<table>  	ржЯрзЗржмрж┐рж▓ рждрзИрж░рж┐ ржХрж░рждрзЗ
<tr>	        ржЯрзЗржмрж┐рж▓ рж░рзЛ
<td>	        ржЯрзЗржмрж┐рж▓ ржбрж╛ржЯрж╛
<th>	        ржЯрзЗржмрж┐рж▓ рж╣рзЗржбрж╛рж░
<thead> 	ржЯрзЗржмрж┐рж▓рзЗрж░ рж╢рзАрж░рзНрж╖ ржЕржВрж╢
<tbody>	        ржЯрзЗржмрж┐рж▓рзЗрж░ ржорзВрж▓ ржЕржВрж╢
<tfoot>	        ржЯрзЗржмрж┐рж▓рзЗрж░ ржирж┐ржЪрзЗрж░ ржЕржВрж╢
<caption>	ржЯрзЗржмрж┐рж▓рзЗрж░ рж╢рж┐рж░рзЛржирж╛ржо

ЁЯУЛ рждрж╛рж▓рж┐ржХрж╛ (List) HTML ржЯрзНржпрж╛ржЧ	ржХрж╛ржЬ

<ul>	        ржЖржиржЕрж░рзНржбрж╛рж░ржб рж▓рж┐рж╕рзНржЯ (тАв)
<ol>	        ржЕрж░рзНржбрж╛рж░ржб рж▓рж┐рж╕рзНржЯ (рзз,рзи,рзй...)
<li>	        рждрж╛рж▓рж┐ржХрж╛рж░ ржЖржЗржЯрзЗржо
<dl>	        ржмрж┐ржмрж░ржг рждрж╛рж▓рж┐ржХрж╛
<dt>	        ржкрж░рж┐ржнрж╛рж╖рж╛ (term)
<dd>	        ржмрзНржпрж╛ржЦрзНржпрж╛ (description)

ЁЯза рж╕рзЗржХрж╢ржи, рж╕рзНржХрзНрж░рж┐ржкрзНржЯ ржУ рж▓ржЬрж┐ржХ HTML ржЯрзНржпрж╛ржЧ ржХрж╛ржЬ

<script>	ржЬрж╛ржнрж╛рж╕рзНржХрзНрж░рж┐ржкрзНржЯ ржХрзЛржб
<noscript>	ржЬрж╛ржнрж╛рж╕рзНржХрзНрж░рж┐ржкрзНржЯ ржирж╛ ржЪрж▓рж▓рзЗ
<canvas>	ржЧрзНрж░рж╛ржлрж┐ржХрзНрж╕/ржбрзНрж░рзЯрж┐ржВ ржПрж░рж┐рзЯрж╛
<template>	ржЯрзЗржоржкрзНрж▓рзЗржЯ ржХржирзНржЯрзЗржирзНржЯ
<slot>	        ржУрзЯрзЗржм ржХржорзНржкрзЛржирзЗржирзНржЯрзЗрж░ ржЬрж╛рзЯржЧрж╛

ЁЯзй ржЗржирзНржЯрж╛рж░тАМрзНржпрж╛ржХржЯрж┐ржн ржПрж▓рж┐ржорзЗржирзНржЯ HTML ржЯрзНржпрж╛ржЧ	ржХрж╛ржЬ

<details>	ржбрзНрж░ржкржбрж╛ржЙржи ржХржиржЯрзЗржирзНржЯ
<summary>	details ржПрж░ рж╢рж┐рж░рзЛржирж╛ржо
<dialog>	ржкржк-ржЖржк ржбрж╛рзЯрж╛рж▓ржЧ ржмржХрзНрж╕

ЁЯМР ржПржорзНржмрзЗржбрзЗржб ржХржиржЯрзЗржирзНржЯ HTML ржЯрзНржпрж╛ржЧ ржХрж╛ржЬ

<iframe>	ржЕржирзНржп ржУрзЯрзЗржмржкрзЗржЬ ржПржорзНржмрзЗржб
<embed> 	ржорж┐ржбрж┐рзЯрж╛ ржмрж╛ ржлрж╛ржЗрж▓ ржПржорзНржмрзЗржб
<object>	ржПржорзНржмрзЗржб ржЕржмржЬрзЗржХрзНржЯ
<param> 	ржЕржмржЬрзЗржХрзНржЯрзЗрж░ рж╕рзЗржЯрж┐ржВ
<picture>	responsive image

ЁЯЫС ржкрзБрж░ржирзЛ/ржЕржкрзНрж░ржЪрж▓рж┐ржд ржЯрзНржпрж╛ржЧ (Deprecated/Obsolete) HTML ржЯрзНржпрж╛ржЧ ржмрзНржпржмрж╣рж╛рж░ ржирж╛ ржХрж░рж╛рж░ ржкрж░рж╛ржорж░рзНрж╢

<font>          ржлржирзНржЯ ржирж┐рж░рзНржзрж╛рж░ржгрзЗрж░ ржЬржирзНржп (CSS ржмрзНржпржмрж╣рж╛рж░ ржХрж░рзБржи)
<center>	ржХрзЗржирзНржжрзНрж░ ржХрж░рзЗ рж▓рзЗржЦрж╛ (CSS ржмрзНржпржмрж╣рж╛рж░ ржХрж░рзБржи)
<marquee>	рж╕рзНржХрзНрж░рж▓рж┐ржВ ржЯрзЗржХрзНрж╕ржЯ (ржЕржкрзНрж░ржЪрж▓рж┐ржд)
<bgsound>	ржмрзНржпрж╛ржХржЧрзНрж░рж╛ржЙржирзНржб рж╕рж╛ржЙржирзНржб (ржЕржкрзНрж░ржЪрж▓рж┐ржд)

ЁЯФЪ ржорзЛржЯ ржЯрзНржпрж╛ржЧ рж╕ржВржЦрзНржпрж╛: ржкрзНрж░рж╛рзЯ рззрззрзжтАУрззрззрзлржЯрж┐ (рж╕рзНржЯрзНржпрж╛ржирзНржбрж╛рж░рзНржб ржЯрзНржпрж╛ржЧ)